#S########
#        #
# ### ## #
# #    # #
# #  # # #
# ## #####
# #      #
# # #  # #
##### ####
#   #    E
# #    # #
##########
